LEVELMARKER
1,0,0,0,0,0,0,0,0,0,0,0,0,0,0,0,0,0,0,0,0,0,0,5,5,5,5,5
1,0,0,0,0,0,0,0,0,0,0,0,0,0,0,0,0,0,0,0,0,0,0,5,5,5,5,5
1,0,0,0,0,0,0,0,0,0,0,0,0,0,0,0,0,0,0,0,0,0,3,5,5,5,5,5
1,0,0,0,0,0,0,0,0,0,0,0,0,0,0,1,0,0,0,0,0,0,1,5,5,5,5,5
1,0,0,0,0,0,0,2,2,0,0,0,0,0,0,1,0,0,0,0,0,0,1,5,5,5,5,5
1,-1,0,0,1,0,2,2,2,0,0,1,0,0,0,1,0,0,0,0,1,1,1,5,5,5,5,5
1,5,5,5,5,5,5,5,5,5,5,5,5,5,5,5,5,5,5,5,5,5,5,5,5,5,5,5
5,5,5,5,5,5,5,5,5,5,5,5,5,5,5,5,5,5,5,5,5,5,5,5,5,5,5,5
LEVELMARKER
5,5,5,0,0,0,0,0,0,0,0,0,0,0,0,0,0,0,0,0,0,0,0,0,0,0,5,5,5,5
5,5,5,3,0,0,0,0,0,0,0,0,0,0,0,0,0,0,0,0,0,0,0,0,0,0,5,5,5,5
5,5,1,1,0,0,0,0,0,0,0,0,0,0,0,0,0,0,0,0,0,0,0,0,0,0,5,5,5,5
5,5,1,0,0,0,0,0,0,0,0,0,0,0,0,0,0,1,0,0,0,0,0,0,0,2,5,5,5,5
5,5,1,0,0,0,0,0,0,2,0,0,0,0,0,0,0,1,0,0,0,0,0,2,2,2,5,5,5,5
5,5,1,-1,1,0,1,0,2,2,0,0,0,1,0,0,0,1,0,0,0,0,1,1,1,1,5,5,5,5
5,5,1,5,5,5,5,5,5,5,5,5,5,5,5,5,5,5,5,5,5,5,5,5,5,5,5,5,5,5
5,5,5,5,5,5,5,5,5,5,5,5,5,5,5,5,5,5,5,5,5,5,5,5,5,5,5,5,5,5
LEVELMARKER
5,5,5,5,5,5,5,5,5,5,5,5,5,5,5,5
5,0,0,0,0,0,0,0,0,0,0,0,5,5,5,5
5,1,-1,0,0,0,0,0,0,0,0,0,5,5,5,5
5,0,1,0,0,0,0,0,0,0,0,0,5,5,5,5
5,0,0,1,0,0,0,0,0,0,0,0,5,5,5,5
5,0,0,0,1,0,0,0,0,0,0,0,5,5,5,5
5,0,0,0,0,1,0,0,0,0,0,0,5,5,5,5
5,0,0,0,0,0,1,0,0,0,0,0,5,5,5,5
5,0,0,0,0,0,0,1,0,0,0,0,5,5,5,5
5,0,0,0,0,0,0,0,0,0,0,0,5,5,5,5
5,0,0,0,0,0,0,0,5,5,5,5,5,5,5,5
5,0,0,0,0,0,0,1,0,0,0,0,5,5,5,5
5,0,0,0,0,0,1,0,0,0,0,0,5,5,5,5
5,0,0,0,0,1,0,0,0,0,0,0,5,5,5,5
5,3,0,0,1,0,0,0,0,0,0,0,5,5,5,5
5,1,1,1,0,0,0,0,0,0,0,0,5,5,5,5
5,5,5,5,5,5,5,5,5,5,5,5,5,5,5,5
5,5,5,5,5,5,5,5,5,5,5,5,5,5,5,5
5,5,5,5,5,5,5,5,5,5,5,5,5,5,5,5
LEVELMARKER
5,5,5,5,5,5,5,5,5,5,5,5,5,5,5,5,5,5,5,5,5,5,5,5,5,5,5,5,5,5,5,5,5
5,5,5,0,0,0,0,0,0,0,0,0,0,0,0,0,0,0,0,0,0,0,0,0,0,0,0,0,0,0,0,5,5
5,5,5,0,0,0,0,0,0,0,0,0,0,0,0,0,0,0,0,0,0,0,0,0,0,0,0,0,0,0,0,5,5
5,5,1,0,0,0,0,0,0,0,0,0,0,0,1,1,0,0,0,0,0,0,0,0,0,0,0,0,0,0,0,5,5
5,5,1,0,0,0,0,0,0,0,0,0,0,0,1,1,0,0,0,0,0,0,0,0,0,0,0,0,0,0,0,5,5
5,5,1,0,0,0,0,0,0,0,0,0,0,0,0,0,0,0,0,0,0,0,0,0,0,0,0,1,0,0,0,5,5
5,5,1,0,0,0,1,0,0,0,0,0,0,0,0,0,0,0,0,0,0,0,0,0,0,0,0,0,0,0,0,5,5
5,5,1,0,0,-1,1,0,0,0,0,0,0,0,1,1,1,0,0,1,0,0,0,0,0,0,0,1,0,0,0,5,5
5,5,1,0,1,1,1,0,0,0,0,0,0,0,1,1,1,0,0,1,1,0,0,0,0,2,2,1,0,0,0,5,5
5,5,1,0,0,0,0,0,0,0,0,0,0,0,0,0,0,0,0,0,0,0,0,0,2,2,2,1,0,0,0,5,5
5,5,1,1,0,0,0,0,0,0,0,0,0,0,0,0,0,0,0,1,0,0,0,2,2,2,2,1,0,0,0,5,5
5,5,1,0,0,0,0,0,0,0,0,0,0,0,1,1,1,1,1,0,0,0,1,1,1,1,1,1,0,0,0,5,5
5,5,1,0,1,1,0,0,0,0,0,0,0,0,1,1,0,0,0,0,0,1,1,0,1,0,0,0,0,0,0,5,5
5,5,1,0,0,0,0,0,0,0,0,0,2,2,1,1,0,0,0,0,0,0,0,0,1,1,1,0,0,0,2,5,5
5,5,1,1,1,1,0,0,0,0,0,2,2,2,1,1,0,0,0,0,0,0,0,0,0,0,0,0,0,0,1,0,5
5,5,0,0,0,0,0,0,0,0,2,2,2,2,1,1,0,0,2,1,0,2,2,0,0,0,0,0,2,0,0,0,5
5,5,0,0,0,2,0,0,0,2,2,1,1,1,1,1,0,2,2,2,2,2,2,2,0,1,0,0,2,2,2,0,5
5,5,0,0,0,2,2,2,5,5,5,5,5,1,1,1,1,1,1,1,1,1,1,1,1,1,1,1,1,1,1,5,5
5,5,5,5,5,5,5,5,5,5,5,5,5,5,5,5,5,5,5,5,5,5,5,5,5,5,5,5,5,5,5,5,5
5,5,5,5,5,5,5,5,5,5,5,5,5,5,5,5,5,5,5,5,5,5,5,5,5,5,5,5,5,5,5,5,5
5,5,5,5,5,5,5,5,5,5,5,5,5,5,5,5,5,5,5,5,5,5,5,5,5,5,5,5,5,5,5,5,5
LEVELMARKER
5,5,5,5,5,5,5,5,5,5,5,5,5,5,5,5
5,0,0,0,0,0,0,0,0,0,0,0,5,5,5,5
5,1,-1,0,0,0,0,0,0,0,0,0,5,5,5,5
5,0,1,0,0,0,0,0,0,0,0,0,5,5,5,5
5,0,0,1,1,1,1,1,0,0,0,0,5,5,5,5
5,0,0,0,1,0,0,0,0,0,0,1,5,5,5,5
5,0,0,0,0,1,0,0,0,0,2,2,5,5,5,5
5,0,0,0,0,0,1,0,0,1,1,1,5,5,5,5
5,0,0,0,0,0,0,0,1,0,0,0,5,5,5,5
5,0,0,0,0,0,0,0,0,0,0,0,5,5,5,5
5,0,0,0,0,0,0,0,5,5,5,5,5,5,5,5
5,0,0,0,0,0,0,1,0,0,0,0,5,5,5,5
5,0,0,0,0,0,1,0,0,0,0,0,5,5,5,5
5,0,0,0,0,0,0,0,0,0,0,0,5,5,5,5
5,3,0,0,1,0,0,0,0,0,0,0,5,5,5,5
5,1,1,1,0,0,0,0,0,0,0,0,5,5,5,5
5,5,5,5,5,5,5,5,5,5,5,5,5,5,5,5
5,5,5,5,5,5,5,5,5,5,5,5,5,5,5,5
5,5,5,5,5,5,5,5,5,5,5,5,5,5,5,5